10 7
###########
#         #
#  $   @  #
#     #   #
#   .     #
#         #
###########